testenus1	Reports of the death of community have been greatly exaggerated.
testenus2	Certainly; I saved that reminder without any additional information.
testenus3	We're so good as regular friends, let's not mess with perfection.
testenus4	I could never pick a favorite color. They all have their own special energy!
testengb1	26 contacts came up.
testengb2	Good morning. Time for another fantastic day.
testengb3	I support love in general but those terms don't really apply to me.
testengb4	Let's just say I could totally see you on a fashion billboard!
testko1	결제하면 유형별 이용내역을 분석한 결과가 여기에 표시됩니다.
testko3	화면의 숨겨진 부분을 캡처한 후, 스크린샷에 메모하거나, 스크린샷을 자르거나 공유합니다.
testko5	활동량과 섭취량을 조절하여 목표 체중을 달성해 보세요.
testko6	실시간 인기곡과 뮤직비디오는 물론, 최고의 무료 라디오까지!
full_en-US_female_gt_utt1	So, Papa is what I should call you?
full_en-US_male_gt_chatbot_510001	The day I met you, I felt a lot like my birthday.
lim_en-US_female_gt_lim_en-US_female_6500	Prime Minister Theresa May is deeply saddened by the tragic loss of life, said Downing Street.
lim_en-US_male_gt_lim_en-US_male_8006_adj	Okay let's take a look, and then, we can apply the icon.
full_en-GB_female_gt_announ_32647	A briefcase has been found in the arrivals area.
full_en-GB_male_gt_announ_32647	A briefcase has been found in the arrivals area.
full_ko_female_gt_Bigdata_00003	  오늘 인천 부평구는, 목요일보다 최고 기온이 일도, 최저 기온도 일도 더 높겠습니다.
full_ko_male_gt_mbwh1_00001	 매일매일 강한 햇볕과 소금기 많은 해풍에 시달려 그네들의 얼굴은 맷양반보다 검으며, 진창과 짠물에 노상 젖은 채여서 손발들이 숯등걸처럼 거칠다.
lim_ko_male_gt_lim_ko_male_0002	그런데 그 이야기라는 것이, 그 노인의 일대기라 할 수 있는 것입니다.
lim_ko_female_gt_lim_ko_female_0003	세 사람은 정말 할 수 있는 일은 다 했다.
